15 10 1.5 1.5 0
###############
#_#__###______#
#_#______######
#_######______#
#__________####
#######_______#
#_______###___#
#_______#######
#_____________#
###############
